(command line) m-x : esc + x
quit/esc : ctrl + g
new/load file in current window : alt + f
new/load file in other window : alt + shift + f
save : alt + s
close window : alt + k
excutes build : alt + m

cycle through word completions : tab

reflow comment alt+.

goto next error after compile : alt+n
goto previous error after compil : alt+shift+n

goto line number : alt+g

list open buffers in current window : alt + b
list open buffers in other window : alt + shift  + b

switch window alt + w

switch between cpp and header : alt + c

set cursor mark : ctrl + space
jump to mark :  alt + shift + ;

indent block : ctrl + tab

copy block : ctrl + q
cut block : ctrl + w
paste block : ctrl + f

undo : alt + u

incrmental search : ctrl + s
move to next search : ctrl + s
move to previous searcn : ctrl + r
query replace : alt + o
replace inside block - alt + l

jump to function by name : alt + j

begin recording keyboard macro : alt+[
stop recording keyboard macro : alt+]
replay keyboard macro : alt+'

skip over words : ctrl + arrows

